#################
#/    @@   @@   #
#     @@@       #
D    @    @@@   #
#      @ @!!@   # 
#  !      @@@ ! #
#       @  @@@  #
#  @   @  @@    #
#################