#####################D######
#                          #
#             @  @    @    #
#      @   @        @    ! #
#               @!      @! #
#        @  !     !  @     #
#      @     @          !  #
#         @                #
#           @ !    @  @   @#
#      @            @   @  #
#/                         #
############################
