#################################################### ###############################
#    /                @@!                      @@!                                 #
#                          @@@@                                                    #
#         @                     @!         @                                       #
#                          @@@                 @                                   #
#                     @@!                      @               @@!                 #
#                @@            @@!             @@!                                 #
#   !                @@!         @!            @@!              @@!                #
#   @@!                @@!           @@!          @@@@                             #
#      @@!                @@!        @@@@           @@!                            #
#          @@@@            @@!            @@@@       @@!                           #
#             @@!            @@!              @@!        @@!                       #
#               @@!             @@!              @@!        @@!                    #
#                  @@!           @@!              @@@@          @@!                #
#                    @@@@          @@!                 @@@@        @@!             #
#                       @@!         @@!                   @@!         @@!          #
#                         @@!         @@!                   @@!        @@@@        #
################################### ####################D###########################
