################D###########
#                          #
D                    ! !   #
#      @    @         @@ ! #
#    @           @   @     #
#           @  @         ! #
#    @@   @        @    !  #
#               ! @    @   #
#     @           @  @     #
#           @   @          #
#/                   !     #
############################
