#######################
#/   @@!   @@!        #
#     @@@@        @@@ #
#  @      @!  @       #
#     @@@   @      @  #
# @@!     @   @@      #
#   @@  @@   @@@    @ #
# !    @@  !  @@!  @@ #
#####D#################
