#####################D######
#           !       @      #
#   !          @ !         #
#     @   @ @   @    @ @   #
#  !    /       !  @       #
#             @        ! @ #
# @@!   @       !          D
#     @         !      !@  #
#   ! @       !!     @     #
#     !   @ !   @      !   #
#           @              #
############################
