############################
#/                         #
#            !         !   #
#       @   @ @  @    !  ! #
#   !             @        #
#           @   !! @    @  #
#   !   @@  @   !          #
#           @@    @    @   #
#           @      @@@@@@@ #
# !      !      !  @  !  @ #
#            !     @   ! @ #
######################D#####
