######################D#####
#  ! ! ! ! ! ! ! ! ! ! !   #
#   !          @ !         #
#     @ @ @ @   @    @ @ ! #
#  !            !  @       #
#             @        ! @ #
# @@!   @ !     !          #
#     @         !      !@  #
#   ! @       !!     @     #
#     !   @ !   @      !   #
# /         @              #
############################
