############################
#     @     @  !    !  ! ! #
#     @ /   @      !   @   #
#  @! @     @!    !  !   ! #
# !   @     @        @     #
#     @@@@@@@ !   !     !  #
# !     !     !     !    @ #
#     !    !     !      !  #
#    @   !!  !     @       #
# !         @    !      !! #
#    ! ! ! ! ! !  !  !  !  D
############################
