#####################D######
#  !              !    !   #
#    !        @  @    @    #
#      @   @      ! @    ! #
# !             @!      @! #
#        @  !     !  @     #
#      @     @          !  #
#  ! @    @                #
#           @ !    @  @   @#
#    @ @     !      @   @  #
#/   @                     #
############################
