###D########################
#/    @@       !      ######
#   @@           @      ####
#   @   @   @@         #####
#  @@               @  #####
#   !   @   @@         @####
#     @@        @@      ####
#  @       !           #####
#                     # ####
#                       ####
#                      #####
############################