############################
#                         !#
D             @@@@         #
#         @    / @  @@     #
#             @@@@         #
#       @            !     #
#           @         @    #
#            @             #
#  @               @  @    #
#         @                #
#    !       @            !#
############################
