############################
#     @     @            ! #
#     @ /   @      !   @   #
#  @! @     @!    !  !   ! #
# !   @     @        @     #
#     @@@@@@@ !         !  #
# !           !     !    @ #
#                       !  #
#    @   !!  !     @       #
# !         @    !      !! #
#    !                     D
############################
