############################
#/    @@   @@   ############
#     @@@       ############
D    @    @@@   ############
#      @ @!!@   # ##########
#  !      @@@ ! ### # ######
#       @  @@@  ############
#  @   @  @@    # ##########
############################
############################
############################
############################
