############################
#                      !   D
#                !   ! !   #
#      @    @         @@ ! #
#    @           @   @     #
#           @  @         ! #
#    @@   @        @    !  #
#               ! @    @   #
#     @           @  @     #
#           @   @          #
#/                   !     #
############################
