#######################################################################################################################################
#                                                                                                                                     #
#   /                                                                                                                                 #
#                     ########   #######   ######   ######     ##       ######## ##     ## ######## ##                                #
#                     ##     ## ##     ## ##    ## ##    ##    ##       ##       ##     ## ##       ##                                #
#                     ##     ## ##     ## ##       ##          ##       ##       ##     ## ##       ##                                #
#                     ########  ##     ##  ######   ######     ##       ######   ##     ## ######   ##                                #
#                     ##     ## ##     ##       ##       ##    ##       ##        ##   ##  ##       ##                                #
#                     ##     ## ##     ## ##    ## ##    ##    ##       ##         ## ##   ##       ##                                #
#                     ########   #######   ######   ######     ######## ########    ###    ######## ########                          #
#                                                                                                                                     #
#                                                                                                                                     #
#           !       @@@               @@       @@                 @@           @   @@@ @@  ! @@      @                                #
#                                                                                                                                     #
#    @!     @@        @!  @!   @@!       @@  @@        @@      @@@    @@      @@  @@        @@      @@@    @@                         #
#                                                                                                                                     #
#   @@     @        @@@     @       @@     @        @!      @@   @     @       @@     @        @!      @@                             #
#    @     @@      @! @@!       @@!   @@!    @@       @    @@      @      !       @@!   @@!    @@       @    @@      @                #
#    !      @@     @@       @@   @!    @@!   @@        @@!        @@         @@   @!    @@!   @@        @@!        @@                 #
#   @@!    @@@@    @       @@     @@        @@@    @@@@      @@!       @@     @@        @@@    @@@@      @@!                          #
#                                                                                                                                     #
#       @@!     @@!    @@     @@@     @@    @@      @@!     @@               @@     @@@     @@    @@      @@!     @@                  #
#   @@@    @        @@   @@      @@       @@     @@    @@@!       @@       @@   @@      @@       @@     @@    @@@!       @@           #
#     @@!      @@@       @@!  @@         @      @@@    @!          @@      !  @@         @      @@@    @!          @@                 #
#      @!      @@!   @@@   @@  @!  @@!   @@@   @@   @@   @@!       @@           @@  @!  @@!   @@@   @@   @@   @@!       @@            #
#######################################################################D###############################################################
