#############D##########
#/   @@  @      @   !  #
# @       @         @@ #
#    @@@     @   @     #
#  @@@     @   @       #
#    @!       @@       #
# @@      @  @      @@ #
#    @       @!   @@   #
########################