############################
#/                         #
#                      !   #
#       @   @ @  @    !  ! #
#                 @        #
#           @   !! @    @  #
#       @@  @   !          #
#           @@    @    @   #
#           @            ! #
# !      !      !          #
#                     !!   #
#############D##############
